R 5000 5000
NO ./textures/wood.xpm
SO ./textures/redbrick.xpm
WE ./textures/greystone.xpm
EA ./textures/colorstone.xpm

S ./textures/barrel.xpm
F 0,255,0
C 0,0,255

11111111111111111111111111111111
12222222222222222222222222222221
12222222222222222222222222222221
12222222222222222222222222222221
12222222222222222222222222222221
12222222222222222222222222222221
12222222222222222222222222222221
12222222222222222222222222222221
12222222222222222222222222222221
12222222222222222222222222222221
12222222222222222222222222222221
12222222222222222222222222222221
12222222222222222222222222222221
12222222222222222222222222222221
12222222222222222222222222222221
12222222222222222222222222222221
12222222222222222222222222222221
12222222222222222222222222222221
12222222222222222222222222222221
12222222222222222222222222222221
12222222222222222222222222222221
12222222222222222222222222222221
12222222222222222222222222222221
12222222222222222222222222222221
100000000000N0000000000000000001
11111111111111111111111111111111
