R 500 500
NO ./textures/wood.xpm
SO ./textures/redbrick.xpm
WE ./textures/greystone.xpm
EA ./textures/colorstone.xpm

S ./textures/barrel.xpm
F 220,100,0
C 225,30,0

11111111
10N00001
10001001
10110201
11010001
11111111
