R 503 503
NO ./textures/wood.xpm
SO ./textures/redbrick.xpm
WE ./textures/greystone.xpm
EA ./textures/colorstone.xpm

S ./textures/barrel.xpm
F 0,255,0
C 0,0,255

11111111111111111111111111
10000000000000000000000001
100000000000E0000002000001
10000000000000000000000001
10000000000000000000000001
10000000000000000000000001
10000000000000000000000001
10000000000000000000000001
10000000000000000000000001
10000000000000000000000001
10000000000000000000000001
10000000000000000000000001
10000000000000000000000001
10000000000000000000000001
10000000000000000000000001
10000000000000000000000001
10000000000000000000000001
10000100000000000001000001
10000000000000000000000001
10000000000000000000000001
11111111111111111111111111
